3222222223322223
1211111112011300
1121122102012321
1302221223211010
1211202110122320
1202120232320201
3301211101233210
1122011323012021
1302011100232210
1022010322032020
1232221022013221
1313112322220201
1010301201222010
1320032013021201
1320220300302120
1203222203220202
0
0
