3222222222222222
1123223233202021
1012010102130200
1130201212303203
1103222120030310
1120131212303001
1302202021023010
1122320322123103
1111023101301010
1113031220120201
1130303023201110
1111012021221003
1110320213201110
1101012101222001
1110233322332210
1222200011001102
0
0
