3232222222222222
1103222212132221
1220322121102311
1323020121120111
1111322211322011
1111132201130111
1111032222303011
1313113321030101
1001111100322211
1111111022130111
1110012221101110
1222232201021101
1132112222321201
1011032220122220
1112302222220111
1302222222201220
