3222222222222323
1230212031311012
1123123130213021
1010312122011302
1111021222011131
3013013122010011
1100201212122020
1303220121222220
1301212103123131
1131103230212101
1110011312121211
1111101121212121
1120320022021210
1222202220202021
3222222222022230
1222222222222202
0
0
