3222222222222223
1323232322222211
1111101123222010
1110311201223211
1113022232130111
1122122101013011
1131320230203011
1300131321330311
1303012003003011
1121320221130111
1131130211303011
1101121301130211
1121020200121211
1302222222202101
1022222222222201
1222222222222220
